pattern,var_name,num_ref_name,CP,VP,mAbs phase3,mAbs structure,other mAbs,all mAbs,num_exp
"W64R,F486S",,1,0,0,0,0,1,1,1
"H245R,L441Q",,1,0,0,0,1,0,1,1
"Y449H,E484K",,1,0,0,0,1,2,3,3
"F486L,F490P",,1,0,0,0,1,2,3,3
"K417V,N439K",,1,0,0,0,2,0,2,2
"P479S,F1121L",,1,0,0,0,2,0,2,2
"E484Q,Q779H",,1,0,0,0,2,0,2,2
"V445R,Y453H",,1,0,0,0,3,0,3,3
"D420Y,N460H",,1,0,0,0,3,0,3,3
"L452R,T478K,P681R",,1,0,0,1,0,0,1,1
"T95I,N354K",,1,0,0,1,0,0,1,1
"K417T,E484K,N501Y",,1,0,0,1,0,0,1,1
"N440K,E484K",,1,0,0,1,0,0,1,1
"N439K,E484K",,1,0,0,1,0,0,1,1
"R346K,E484K,N501Y",,1,0,0,1,0,0,1,1
"G261D,Y453F",,2,0,0,1,2,0,3,3
"E484K,R683G",,1,0,0,1,5,8,14,14
"K417N,E484K,N501Y,R683G",,1,0,0,1,5,8,14,14
"L455R,E484K,R683G",,1,0,0,1,5,8,14,14
"K417N,L452R,T478K",,1,0,0,2,0,0,2,2
"L452R,T478K",,2,0,0,6,0,0,6,6
"69-70∆,Y453F,F486L,N501T,M1229I",,1,0,0,6,0,0,6,6
"Y453F,Q498H",,1,0,0,6,0,0,6,6
"R246N,247-253∆",,1,0,18,0,0,0,0,18
"G75V,T76I,L452Q,F490S,T859N",,1,0,18,0,0,0,0,18
"L452Q,F490S",,2,0,18,3,0,0,3,21
"T95I,D253G",,1,0,30,0,0,0,0,30
"T95I,D253G,S477N",,1,0,30,0,0,0,0,30
"T95I,D253G,E484K",,1,0,30,0,0,0,0,30
"69-70∆,141-145∆,E154Q,E484K,N501Y",,1,0,30,0,0,0,0,30
"G142D,157-158∆,R158G,L452R,T478K",,1,0,30,0,0,0,0,30
"D80G,141-145∆,F157S,L452R,T791I,T859N,D950H",,1,0,32,0,0,0,0,32
"G446V,F456V,E484P",,1,1,0,0,0,0,0,1
"141-145∆,E484G",,1,1,1,0,0,0,0,2
"141-145∆,F490L",,1,1,1,0,0,0,0,2
"244-247∆,E484G",,1,1,1,0,0,0,0,2
"244-247∆,F490L",,1,1,1,0,0,0,0,2
"69-70∆,D796H",,1,3,0,0,3,6,9,12
"T345A,L517R",,1,4,0,0,1,9,10,14
"S477N,S514F",,1,4,0,0,1,9,10,14
"K417N,G446V,E484K",,1,6,6,0,0,0,0,12
"141-145∆,R408I",,1,10,0,2,4,7,13,23
"N501Y,Q677H",,1,10,5,3,0,0,3,18
"69-70∆,N501Y,A570D",,1,10,18,0,0,0,0,28
"L5F,Q1208H",,1,12,0,0,0,0,0,12
"L18F,A222V",,1,12,0,0,0,0,0,12
"69-70∆,N439K",,3,12,0,7,0,0,7,19
"69-70∆,N501Y,P681H",,3,12,8,3,0,0,3,23
"145-146∆,E484K",,1,16,18,6,0,0,6,40
"L452R,E484Q",,4,16,52,4,0,0,4,72
"L452R,E484Q,P681R",,3,16,52,7,0,0,7,75
"G75V,T76I",,3,16,60,6,0,0,6,82
"S13I,141-145∆,244-247∆,F490L",,1,21,0,0,0,0,0,21
"141-145∆,Y248ins,E484K",,1,40,0,0,0,26,26,66
"69-70∆,Y453F",,3,42,22,7,6,3,16,80
"69-70∆,N501Y",,6,42,42,20,10,23,53,137
"K417N,E484K",,2,48,10,1,2,14,17,75
"K417N,N501Y",,2,48,10,1,2,14,17,75
"E484K,N501Y",,4,67,78,6,6,26,38,183
"K417N,E484K,N501Y",,17,286,102,40,21,102,163,551
"R102I,F157L,V367F,E484K,Q613H,P681R",A.23.1,2,0,8,1,0,0,1,9
"F157L,V367F,Q613H,P681R",A.23.1,2,10,8,0,0,0,0,18
"L18F,A222V,L452R,N501Y,A653V,H655Y,D796Y,G1219V",A.27/A222V,1,0,6,0,0,0,0,6
"D80Y,141-145∆,210∆,D215G,244-247∆,L249M,W258L,R346K,T478R,E484K,H655Y,P681H,Q957H",A.VOI.V2,1,0,8,0,0,0,0,8
"69-70∆,T124I,141-145∆,N501Y,A570D,P681H,T716I,S982A,D1118H",Alpha,1,0,35,0,0,0,0,35
"69-70∆,141-145∆,N501Y,A570D,P681H,T716I,L938F,S982A,D1118H",Alpha,1,0,36,0,0,0,0,36
"69-70∆,141-145∆,141-145∆,N501Y,A570D,P681H,T716I,S982A,D1118H",Alpha,1,0,60,0,0,0,0,60
"69-70∆,141-145∆,N439K,N501Y,A570D,P681H,A684V,T716I,S982A,C1032S,D1118H",Alpha,1,20,29,0,0,0,0,49
"69-70∆,141-145∆,N501Y,P681H,T716I,S982A,D1118H",Alpha,1,42,0,0,0,0,0,42
"69-70∆,N74K,141-145∆,N501Y,A570D,P681H,T716I,S982A,D1118H",Alpha,1,54,30,0,0,0,0,84
"69-70∆,141-145∆,N501Y,A570D,P681H,T716I,A831V,S982A,D1118H",Alpha,1,61,356,0,0,0,0,417
"69-70∆,141-145∆,N501Y,A570D,P681H,T716I,S982A",Alpha,1,96,64,0,0,0,0,160
"69-70∆,141-145∆,N501Y,A570D,P681H,T716I,S982A,D1118H",Alpha,90,1757,3784,103,54,144,301,5842
"69-70∆,141-145∆,E484K,S494P,N501Y,A570D,P681H,T716I,S982A,D1118H",Alpha/E484K,1,20,30,0,0,16,16,66
"69-70∆,141-145∆,E484K,N501Y,A570D,P681H,T716I,S982A,D1118H",Alpha/E484K,10,136,126,13,0,8,21,283
"M153T,T385I",B.1.1.141,1,0,27,0,0,0,0,27
"V3G,L5F,S477N",B.1.1.241,1,34,0,0,0,0,0,34
"69-70∆,Y453F,I692V,M1229I",B.1.1.298,1,12,0,1,0,12,13,25
"69-70∆,Y453F,I692V,S1147L,M1229I",B.1.1.298,1,18,0,3,0,0,3,21
"Y453F,I692V,M1229I",B.1.1.298,3,61,77,0,0,0,0,138
"D138Y,S477N,A522S,Q675R,A845S",B.1.1.317,1,0,27,0,0,0,0,27
"T95I,141-145∆,E484K,P681H,D796H",B.1.1.318,1,12,0,1,0,12,13,25
"A27S,P681H",B.1.1.50,1,0,18,0,0,0,0,18
"T478K,P681H,T732A",B.1.1.519,2,0,0,10,0,2,12,12
"F59Y,P384L,P812S",B.1.463,1,50,170,0,0,0,0,220
"N501T,Q613H,G639V",B.1.517,1,0,32,0,0,0,0,32
"T19R,G142D,E156G,157-158∆,L452R,E484Q,P681R,D950N",B.1.617.3,1,0,16,0,0,0,0,16
"T19R,G142D,157-158∆,R158G,L452R,E484Q,P681R,D950N",B.1.617.3,1,0,86,0,0,0,0,86
"H49Y,145-146∆,E484K",B.1.618,1,0,20,0,0,0,0,20
"I210T,N440K,E484K,D936N,S939F,T1027I",B.1.619,1,0,0,1,0,0,1,1
"E484K,N501T",B.1/E484K,1,0,32,0,0,0,0,32
"D80Y,D215Y,242-244∆,K417N,E484K,N501Y,A701V",Beta,2,0,0,4,0,0,4,4
"D80A,D215G,242-244∆,K417N,E484K,N501Y",Beta,1,0,30,0,0,0,0,30
"L18F,D80A,D215G,242-244∆,K417N,E484K,N501Y,Q677H,R682W,A701V",Beta,1,0,32,0,0,0,0,32
"L18F,D80A,D215G,242-244∆,K417N,E484K,N501Y,A701V,S943P",Beta,1,0,60,0,0,0,0,60
"D80A,242-244∆,K417N,E484K,N501Y,A701V",Beta,1,16,0,0,0,0,0,16
"D80A,D215G,242-244∆,K417N,E484K,N501Y,A701V,Q836L",Beta,1,18,28,0,0,0,0,46
"L18F,D80A,242-244∆,K417N,E484K,N501Y,A701V",Beta,1,20,0,0,0,0,0,20
"L18F,D80A,D215G,242-244∆,S305T,K417N,E484K,N501Y,A701V",Beta,1,24,0,6,6,0,12,36
"D80A,D215G,K417N,E484K,N501Y,A701V",Beta,2,35,59,0,2,2,4,98
"L18F,D80A,D215G,K417N,E484K,N501Y,A701V",Beta,1,48,0,1,2,14,17,65
"T19I,D80A,D215G,242-244∆,K417N,E484K,N501Y,A701V",Beta,1,61,356,0,0,0,0,417
"L18F,D80A,D215G,L242H,R246I,K417N,E484K,N501Y,A701V",Beta,1,69,50,0,1,3,4,123
"D80A,242-244∆,R246I,K417N,E484K,N501Y,A701V",Beta,3,70,146,0,0,0,0,216
"T19I,D80A,D215G,242-244∆,E484K,N501Y,A701V",Beta,1,76,0,0,0,0,0,76
"L18F,D80A,D215G,R246I,K417N,E484K,N501Y,A701V",Beta,3,96,0,3,0,0,3,99
"D80A,D215G,242-244∆,A243P,K417N,E484K,N501Y,A701V",Beta,1,107,0,0,0,0,0,107
"D80A,D215G,242-244∆,K417N,E484K,N501Y,A701V",Beta,11,130,239,1,2,14,17,386
"L18F,D80A,D215G,242-244∆,K417N,E484K,N501Y,A701V",Beta,20,364,514,10,2,22,34,912
"L18F,D80A,D215G,242-244∆,R246I,K417N,E484K,N501Y,A701V",Beta,68,1215,3319,99,30,60,189,4723
"D80A,D215G,E484K,N501Y,A701V",Beta w/o K417N,2,48,0,3,2,14,19,67
"L5F,T19R,G142D,157-158∆,R158G,L452R,Q613H,P681R,D950N",Delta,1,0,0,1,0,0,1,1
"T19R,T95I,E156G,157-158∆,L452R,T478K,P681R,D950N",Delta,1,0,19,0,0,0,0,19
"T19R,G142D,L452R,T478K,P681R,D950N",Delta,1,0,20,0,0,0,0,20
"G142D,E154K,157-158∆,A222V,L452R,T478K,P681R,D950N",Delta,1,0,28,0,0,0,0,28
"T19R,G142D,157-158∆,R158G,L452R,T478K,P681R,D950N,L1141W",Delta,1,0,32,0,0,0,0,32
"T19R,157-158∆,R158G,L452R,T478K,P681R,D950N",Delta,1,0,58,0,0,0,0,58
"T19R,T95I,157-158∆,R158G,K417N,L452R,T478K,P681R",Delta,1,0,86,0,0,0,0,86
"T19R,G142D,E156G,157-158∆,L452R,T478K,P681R,D950N",Delta,7,0,88,9,0,8,17,105
"E156G,157-158∆,A222V,L452R,T478K,P681R,D950D",Delta,1,0,502,0,0,0,0,502
"T19R,T95I,G142D,E156G,157-158∆,L452R,T478K,P681R,D950N",Delta,1,10,0,0,0,0,0,10
"T19R,G142D,157-158∆,R158G,L452R,T478K,P681R,D950N",Delta,5,16,216,7,0,0,7,239
"T19R,T95I,G142D,157-158∆,R158G,A222V,L452R,T478K,P681R,D950N",Delta,1,20,36,0,0,0,0,56
"T19R,G142D,A222V,L452R,T478K,P681R,D950N",Delta,2,20,103,0,0,0,0,123
"T19R,K77T,G142D,157-158∆,R158G,L452R,T478K,P681R,D950N",Delta,1,24,25,0,0,0,0,49
"T19R,157-158∆,L452R,T478K,P681R,D950N",Delta,1,116,0,0,0,0,0,116
"T19R,E156G,157-158∆,L452R,T478K,P681R,D950N",Delta,12,202,699,21,0,7,28,929
"T19R,G142D,157-158∆,R158G,K417N,L452R,T478K,P681R,D950N",Delta plus,3,8,86,5,0,0,5,99
"S13I,P26S,W152C,L452R",Epsilon,1,0,8,0,0,0,0,8
"S13I,W152C,W258L,L452R",Epsilon,1,20,36,0,0,0,0,56
"S13I,W152C,L452R",Epsilon,21,109,631,30,9,49,88,828
"S13I,W152C,L452R,E484K",Epsilon/E484K,1,0,0,8,0,8,16,16
"Q52R,A67V,69-70∆,141-145∆,E484K,Q677H,F888L",Eta,9,28,174,2,0,12,14,216
"L18F,T20N,P26S,D138Y,R190S,K417T,E484K,N501Y,H655Y,I692F,T1027I,V1176F",Gamma,1,0,44,0,0,0,0,44
"L18F,T20N,P26S,D138Y,R190S,K417T,E484K,N501Y,H655Y,P812S,S813N,T1027I,V1176F",Gamma,1,0,60,0,0,0,0,60
"L18F,T20N,P26S,D138Y,R190S,K417T,E484K,N501Y,H655Y",Gamma,1,20,22,7,9,2,18,60
"L18F,T20N,P26S,D138Y,N354K,K417T,E484K,N501Y,H655Y,T1027S,V1176F",Gamma,1,21,71,0,0,0,0,92
"L18F,T20N,P26S,D138Y,R190S,K417T,E484K,N501Y,H655Y,T1027I",Gamma,5,69,200,11,1,11,23,292
"L18F,T20N,P26S,D138Y,G181V,R190S,K417T,E484K,N501Y,H655Y,T1027I,V1176F",Gamma,4,171,66,0,0,0,0,237
"L18F,T20N,P26S,D138Y,R190S,K417T,E484K,N501Y,H655Y,T1027I,V1176F",Gamma,45,768,1329,60,15,44,119,2216
"L5F,T95I,D253G,E484K,A701V",Iota,14,88,263,36,8,22,66,417
"L5F,T95I,D253G,S477N,A701V",Iota w/o E484K,2,6,40,3,0,0,3,49
"L5F,T95I,D253G,S477N,Q957R",Iota w/o E484K,4,32,42,3,0,12,15,89
"E154K,L452R,E484Q,P681R,D950N,E1072K,K1073R",Kappa,1,0,8,0,0,0,0,8
"R21T,E154K,Q218H,L452R,E484Q,P681R,H1101D",Kappa,1,15,15,6,0,0,6,36
"G142D,E154K,V382L,L452R,E484Q,P681R,Q1106H",Kappa,1,20,30,0,0,16,16,66
"T95I,G142D,E154K,L452R,E484Q,P681R,Q1071H",Kappa,11,20,365,12,0,8,20,405
"G142D,E154K,L452R,E484Q,P681R,Q1071H,H1101D",Kappa,8,44,146,4,0,0,4,194
"T95I,G142D,E154K,L452R,E484Q,P681R,Q1071H,H1101D",Kappa,2,79,58,9,0,2,11,148
"G75V,T76I,R246N,247-253∆,L452Q,F490S,T859N",Lambda,1,0,18,0,0,0,0,18
"63-75∆,247-253∆,D253N,L452Q,E471Q,F490S",Lambda,1,0,30,0,0,0,0,30
"G75V,T76I,247-253∆,D253N,A262S,L452Q,F490S,T859N",Lambda,1,0,35,0,0,0,0,35
"G75V,T76I,247-253∆,L452Q,F490S,M869N",Lambda,4,16,217,7,0,0,7,240
"T95I,Y144S,Y145N,R346K,E484K,N501Y,P681H,D950N",Mu,2,0,37,2,0,0,2,39
"W152L,E484K,K558N,G769V",R.1,1,0,32,0,0,0,0,32
"E484K,Q677H,T732S,E1202Q",R.2,1,0,0,1,0,0,1,1
"E484K,V1176F",Zeta,7,101,143,9,0,20,29,273
