Variant name,Nickname,CP,VP,mAbs phase3,mAbs structure,other mAbs,all mAbs
"W64R,F486S",,0,0,0,0,1,1
"H245R,L441Q",,0,0,0,1,0,1
"Y449H,E484K",,0,0,0,1,2,3
"F486L,F490P",,0,0,0,1,2,3
"K417V,N439K",,0,0,0,2,0,2
"P479S,F1121L",,0,0,0,2,0,2
"E484Q,Q779H",,0,0,0,2,0,2
"D420Y,N460H",,0,0,0,3,0,3
"V445R,Y453H",,0,0,0,3,0,3
"I210T,N440K,E484K,D936N,S939F,T1027I",,0,0,1,0,0,1
"E484K,Q677H,T732S,E1202Q",,0,0,1,0,0,1
"T95I,N354K",,0,0,1,0,0,1
"L452R,T478K,P681R",,0,0,1,0,0,1
"G261D,Y453F",,0,0,1,2,0,3
"K417N,E484K,N501Y,R683G",,0,0,1,5,8,14
"L455R,E484K,R683G",,0,0,1,5,8,14
"E484K,R683G",,0,0,1,5,8,14
"D80Y,D215Y,242-244∆,K417N,E484K,N501Y,A701V",,0,0,3,0,0,3
"Y453F,Q498H",,0,0,3,0,0,3
"69-70∆,Y453F,F486L,N501T,M1229I",,0,0,3,0,0,3
"S13I,W152C,L452R,E484K",,0,0,4,0,4,8
"L452R,T478K",,0,0,6,0,0,6
"T19R,G142D,E156G,157-158∆,L452R,E484Q,P681R,D950N",,0,16,0,0,0,0
"G75V,T76I,R246N,247-253∆,L452Q,F490S,T859N",,0,18,0,0,0,0
"G75V,T76I,L452Q,F490S,T859N",,0,18,0,0,0,0
"R246N,247-253∆",,0,18,0,0,0,0
"L452Q,F490S",,0,18,0,0,0,0
"G142D,E154K,157-158∆,A222V,L452R,T478K,P681R,D950N",,0,28,0,0,0,0
"T95I,D253G",,0,30,0,0,0,0
"T95I,D253G,S477N",,0,30,0,0,0,0
"T95I,D253G,E484K",,0,30,0,0,0,0
"69-70∆,141-145∆,E154Q,E484K,N501Y",,0,30,0,0,0,0
"G142D,157-158∆,R158G,L452R,T478K",,0,30,0,0,0,0
"D80A,D215G,242-244∆,K417N,E484K,N501Y",,0,30,0,0,0,0
"63-75∆,247-253∆,D253N,L452Q,E471Q,F490S",,0,30,0,0,0,0
"G446V,F456V,E484P",,1,0,0,0,0,0
"244-247∆,F490L",,1,1,0,0,0,0
"244-247∆,E484G",,1,1,0,0,0,0
"141-145∆,E484G",,1,1,0,0,0,0
"141-145∆,F490L",,1,1,0,0,0,0
"S477N,S514F",,4,0,0,0,0,0
"T345A,L517R",,4,0,0,0,0,0
"K417N,G446V,E484K",,6,6,0,0,0,0
"T19R,G142D,157-158∆,R158G,K417N,L452R,T478K,P681R,D950N",,8,46,3,0,0,3
"141-145∆,R408I",,10,0,2,4,7,13
"L5F,Q1208H",,12,0,0,0,0,0
"L18F,A222V",,12,0,0,0,0,0
"69-70∆,N439K",,12,0,4,0,0,4
"145-146∆,E484K",,16,18,6,0,0,6
"L452R,E484Q",,16,52,4,0,0,4
"L452R,E484Q,P681R",,16,52,7,0,0,7
"G75V,T76I",,16,60,6,0,0,6
"L18F,T20N,P26S,D138Y,R190S,K417T,E484K,N501Y,H655Y",,20,22,7,9,2,18
"69-70∆,Y453F",,27,11,4,6,3,13
"L18F,D80A,D215G,K417N,E484K,N501Y,A701V",,48,0,1,2,14,17
"D80A,D215G,E484K,N501Y,A701V",,48,0,3,2,14,19
"L18F,D80A,D215G,L242H,R246I,K417N,E484K,N501Y,A701V",,69,50,0,1,3,4
"L18F,T20N,P26S,D138Y,R190S,K417T,E484K,N501Y,H655Y,T1027I",,69,200,6,1,7,14
"69-70∆,141-145∆,N501Y,A570D,P681H,T716I,S982A",,96,64,0,0,0,0
"F157L,V367F,Q613H,P681R",A.23.,10,8,0,0,0,0
"R102I,F157L,V367F,E484K,Q613H,P681R",A.23.1 :+102I+484,0,8,1,0,0,1
"L18F,A222V,L452R,N501Y,A653V,H655Y,D796Y,G1219V",A.27.R,0,6,0,0,0,0
"D80Y,141-145∆,210∆,D215G,244-247∆,L249M,W258L,R346K,T478R,E484K,H655Y,P681H,Q957H",A.VOI.V,0,8,0,0,0,0
"69-70∆,N501Y,A570D",Alpha (variation),10,18,0,0,0,0
"69-70∆,N501Y,P681H",Alpha (variation),12,8,3,0,0,3
"69-70∆,N501Y",Alpha (variation),27,31,14,11,19,44
"Y453F,I692V,M1229I",B.1.1.29,61,77,0,0,0,0
"69-70∆,Y453F,I692V,M1229I",B.1.1.298 :+69del+70de,5,0,1,0,12,13
"T95I,141-145∆,E484K,P681H,D796H",B.1.1.31,5,0,1,0,12,13
"A27S,P681H",B.1.1.50,0,18,0,0,0,0
"T478K,P681H,T732A",B.1.1.51,0,0,10,0,2,12
"69-70∆,141-145∆,N501Y,A570D,P681H,T716I,S982A,D1118H",B.1.1.7,1482,3965,90,57,139,286
"69-70∆,141-145∆,E484K,N501Y,A570D,P681H,T716I,S982A,D1118H",B.1.1.7 + 484 (variation),136,126,7,1,4,12
"69-70∆,141-145∆,E484K,S494P,N501Y,A570D,P681H,T716I,S982A,D1118H",B.1.1.7 + 484K+494 (variation),20,30,0,0,8,8
"69-70∆,141-145∆,N439K,N501Y,A570D,P681H,A684V,T716I,S982A,C1032S,D1118H",B.1.1.7_MZ427280,20,29,0,0,0,0
"D80A,D215G,K417N,E484K,N501Y,A701V",B.1.351,35,59,0,2,2,4
"L18F,D80A,D215G,242-244∆,R246I,K417N,E484K,N501Y,A701V",B.1.351,1033,3528,86,33,55,174
"D80A,242-244∆,K417N,E484K,N501Y,A701V",B.1.351 :-18F+241del-244del-246 (variation),16,0,0,0,0,0
"L18F,D80A,D215G,R246I,K417N,E484K,N501Y,A701V",B.1.351 :-242del-243del-244de (variation),96,0,3,0,0,3
"L18F,D80A,D215G,242-244∆,K417N,E484K,N501Y,A701V",B.1.351 :-246 (variation),261,423,6,2,18,26
"K417N,E484K,N501Y",B.1.351 RB,286,102,31,23,98,152
"L18F,D80A,D215G,242-244∆,S305T,K417N,E484K,N501Y,A701V",B.1.351_70045,24,0,6,6,0,12
"D80A,D215G,242-244∆,K417N,E484K,N501Y,A701V,Q836L",B.1.351_MW822592,18,28,0,0,0,0
"L18F,D80A,D215G,242-244∆,K417N,E484K,N501Y,Q677H,R682W,A701V",B.1.351_MZ20231,0,32,0,0,0,0
"D80A,D215G,242-244∆,K417N,E484K,N501Y,A701V",B.1.351_MZ46800,72,209,1,2,14,17
"S13I,P26S,W152C,L452R",B.1.427/9 + 26 (variation),0,8,0,0,0,0
"N501T,Q613H,G639V",B.1.517_MZ46800,0,32,0,0,0,0
"L5F,T95I,D253G,E484K,A701V",B.1.52,41,689,13,1,16,30
"Q52R,A67V,69-70∆,141-145∆,E484K,Q677H,F888L",B.1.525 :+144del-145de,21,174,2,0,12,14
"L5F,T95I,D253G,S477N,Q957R",B.1.526 v.,25,42,1,1,12,14
"D80G,141-145∆,F157S,L452R,T791I,T859N,D950H",B.1.526_MZ46732,0,32,0,0,0,0
"L5F,T95I,D253G,S477N,A701V",B.1.526_MZ46733,6,40,3,0,0,3
"H49Y,145-146∆,E484K",B.1.61,0,20,0,0,0,0
"T95I,G142D,E154K,L452R,E484Q,P681R,Q1071H",B.1.617,0,190,6,0,4,10
"E154K,L452R,E484Q,P681R,D950N,E1072K,K1073R",B.1.617  v,0,8,0,0,0,0
"T19R,L452R,E484Q,P681R",B.1.617.,0,0,1,0,0,1
"G142D,E154K,V382L,L452R,E484Q,P681R,Q1106H",B.1.617.1 :+382L-1071H-1101D+1106,20,30,0,0,8,8
"T95I,G142D,E154K,L452R,E484Q,P681R,Q1071H,H1101D",B.1.617.1 :+95I-1101,79,58,9,0,2,11
"R21T,E154K,Q218H,L452R,E484Q,P681R,H1101D",B.1.617.1_136038,15,15,6,0,0,6
"T19R,E156G,157-158∆,L452R,T478K,P681R,D950N",B.1.617.2,155,585,14,0,7,21
"T19R,G142D,E156G,157-158∆,L452R,T478K,P681R,D950N",B.1.617.2 :+142,0,88,5,0,4,9
"T19R,G142D,L452R,T478K,P681R,D950N",B.1.617.2 :+142D-156G-157del-158de,0,20,0,0,0,0
"T19R,157-158∆,L452R,T478K,P681R,D950N",B.1.617.2 :-156 (variation),116,0,0,0,0,0
"E156G,157-158∆,A222V,L452R,T478K,P681R,D950D",B.1.617.2_173101,0,502,0,0,0,0
"T19R,G142D,A222V,L452R,T478K,P681R,D950N",B.1.617.2_240052,20,17,0,0,0,0
"T19R,G142D,157-158∆,R158G,L452R,T478K,P681R,D950N,L1141W",B.1.617.2_MZ46804,0,32,0,0,0,0
"T95I,Y144S,Y145N,R346K,E484K,N501Y,P681H,D950N",B.1.621,0,37,0,0,0,0
"E484K,N501T",B.1_MZ46798,0,32,0,0,0,0
"K417N,E484K",Beta (variation),48,10,1,2,14,17
"K417N,N501Y",Beta (variation),48,10,1,2,14,17
"G75V,T76I,247-253∆,L452Q,F490S,M869N",C.3,16,217,6,0,0,6
"N501Y,Q677H",COH.20G/677,10,5,3,0,0,3
"69-70∆,141-145∆,N501Y,P681H,T716I,S982A,D1118H",England/MIG457/202,42,0,0,0,0,0
"S13I,W152C,L452R",Epsilon,59,570,19,11,45,75
"K417T,E484K,N501Y",Gamma (variation),0,0,1,0,0,1
"K417T,E484K",Gamma (variation),0,0,1,0,0,1
"69-70∆,D796H",Kemp21-d10,3,0,0,3,6,9
"69-70∆,Y453F,I692V,S1147L,M1229I",Mink Cluster,18,0,3,0,0,3
"E484K,V1176F",P.,77,143,5,0,16,21
"L18F,T20N,P26S,D138Y,R190S,K417T,E484K,N501Y,H655Y,T1027I,V1176F",P.,436,1835,49,17,40,106
"L18F,T20N,P26S,D138Y,N354K,K417T,E484K,N501Y,H655Y,T1027S,V1176F",P.1,21,71,0,0,0,0
"141-145∆,Y248ins,E484K",PT188_E,40,0,0,0,0,0
"W152L,E484K,K558N,G769V",R.1_MZ46769,0,32,0,0,0,0
"69-70∆,141-145∆,N501Y,A570D,P681H,T716I,A831V,S982A,D1118H",SARS-CoV-2/human/FIN/87HEL-VE6-H10/202,61,356,0,0,0,0
"T19I,D80A,D215G,242-244∆,K417N,E484K,N501Y,A701V",SARS-CoV-2/human/FIN/HEL-12-102-VE6-H10/202,61,356,0,0,0,0
"F59Y,P384L,P812S",SARS-CoV-2/human/FIN/SR121-VE6-H10/202,50,170,0,0,0,0
"E484K,N501Y",WA1+ 484K+501Y+614 (variation),67,78,5,7,26,38
"D80A,242-244∆,R246I,K417N,E484K,N501Y,A701V",WA1+ 80A+242del+243del+244del+246I+417N+484K+501Y+614G+701 (variation),70,146,0,0,0,0
"S13I,141-145∆,244-247∆,F490L",Weigang21_d10,21,0,0,0,0,0
"69-70∆,141-145∆,N501Y,A570D,P681H,T716I,L938F,S982A,D1118H",hCoV-19/Argentina/INEIINBIRS-14/202,0,36,0,0,0,0
"G75V,T76I,247-253∆,D253N,A262S,L452Q,F490S,T859N",hCoV-19/Argentina/PAIS-A0612/202,0,35,0,0,0,0
"T19R,G142D,157-158∆,R158G,L452R,T478K,P681R,D950N",hCoV-19/England/ALDP-154DD71/2021,16,143,7,0,0,7
"T19I,D80A,D215G,242-244∆,E484K,N501Y,A701V",hCoV-19/Finland/HEL-12-102/202,38,0,0,0,0,0
"D80A,D215G,242-244∆,A243P,K417N,E484K,N501Y,A701V",hCoV-19/France/IDF-IPP00078/202,107,0,0,0,0,0
"T19R,T95I,E156G,157-158∆,L452R,T478K,P681R,D950N",hCoV-19/Israel/CVL-12806/202,0,19,0,0,0,0
"L18F,T20N,P26S,D138Y,R190S,K417T,E484K,N501Y,H655Y,P812S,S813N,T1027I,V1176F",hCoV-19/Italy/TUS-Siena12/202,0,60,0,0,0,0
"69-70∆,141-145∆,141-145∆,N501Y,A570D,P681H,T716I,S982A,D1118H",hCoV-19/Italy/TUS-Siena2/202,0,60,0,0,0,0
"L18F,D80A,D215G,242-244∆,K417N,E484K,N501Y,A701V,S943P",hCoV-19/Italy/TUS-Siena7/202,0,60,0,0,0,0
"L18F,T20N,P26S,D138Y,G181V,R190S,K417T,E484K,N501Y,H655Y,T1027I,V1176F",hCoV-19/Japan/TY7-501/202,171,66,0,0,0,0
"69-70∆,T124I,141-145∆,N501Y,A570D,P681H,T716I,S982A,D1118H",hCoV-19/Netherlands/NoordHolland_20432/202,0,35,0,0,0,0
"M153T,T385I",hCoV-19/Russia/MOW-PMVL-31/202,0,27,0,0,0,0
"D138Y,S477N,A522S,Q675R,A845S",hCoV-19/Russia/MOW-PMVL-43/202,0,27,0,0,0,0
"G142D,E154K,L452R,E484Q,P681R,Q1071H,H1101D",hCoV-19/South Korea/KDCA2950/202,44,146,2,0,0,2
"L5F,T19R,G142D,157-158∆,R158G,L452R,Q613H,P681R,D950N",hCoV-19/South Korea/KDCA5439/202,0,0,1,0,0,1
"T19R,T95I,G142D,E156G,157-158∆,L452R,T478K,P681R,D950N",hCoV-19/USA/WI-UW-5250/202,10,0,0,0,0,0
"T19R,K77T,G142D,157-158∆,R158G,L452R,T478K,P681R,D950N",hCoV19/USA/PHC658/202,24,25,0,0,0,0
