Variant name,Nickname,CP,VP,mAbs phase3,mAbs structure,other mAbs,all mAbs
"N439K,F1121L",,0,0,0,2,0,2
"G261D,A475V",,0,0,0,2,0,2
"F490L,Q779H",,0,0,0,2,0,2
"G261D,Y453F",,0,0,1,0,0,1
"T95I,N354K",,0,0,1,0,0,1
"N354D,D364Y",,0,0,1,0,0,1
"Y453F,Q498H",,0,0,1,0,0,1
"69-70∆,Y453F,F486L,N501T,M1229I",,0,0,1,0,0,1
"141-145∆,R408I",,0,0,2,4,7,13
"G446P,F456V,E484P",,1,0,0,0,0,0
"S477N,S514F",,2,0,0,0,0,0
"T345A,L517R",,2,0,0,0,0,0
"K417N,G446V,E484K",,5,6,0,0,0,0
"69-70∆,N439K",,11,0,3,0,0,3
"L5F,Q1208H",,12,0,0,0,0,0
"L18F,A222V",,12,0,0,0,0,0
"69-70∆,Y453F",,27,11,4,6,3,13
"E484K,N501Y",,67,54,5,5,23,33
"L18F,A222V,L452R,N501Y,A653V,H655Y,D796Y,G1219V",A.27.RN,0,6,0,0,0,0
"Y453F,I692V,M1229I",B.1.1.298,0,26,0,0,0,0
"69-70∆,N501Y,A570D,P681H,T716I,S982A,D1118H",B.1.1.7,530,747,73,41,114,228
"69-70∆,N501Y,A570D",B.1.1.7 (variation),10,15,0,0,0,0
"69-70∆,N501Y",B.1.1.7 (variation),27,31,15,9,20,44
"69-70∆,N501Y,P681H",B.1.1.7 (variation),30,13,2,0,0,2
"69-70∆,E484K,N501Y,A570D,P681H,T716I,S982A,D1118H",B.1.1.7 + 484K (variation),20,58,0,0,1,1
"69-70∆,N501Y,A570D,P681H",B.1.1.7 S1,0,0,1,0,0,1
"L18F,D80A,D215G,242-244∆,R246I,K417N,E484K,N501Y,A701V",B.1.351,469,550,68,30,49,147
"K417N,E484K",B.1.351 (variation),48,10,0,3,14,17
"K417N,N501Y",B.1.351 (variation),48,10,0,3,14,17
"D80A,242-244∆,R246I,K417N,E484K,N501Y,A701V",B.1.351 :-18F-215G (variation),0,23,0,0,0,0
"D80A,D215G,K417N,E484K,N501Y,A701V",B.1.351 :-18F-242del-243del-244del-246I (variation),6,39,0,1,2,3
"D80A,D215G,E484K,N501Y,A701V",B.1.351 :-18F-242del-243del-244del-246I-417N (variation),48,0,2,3,14,19
"D80A,D215G,242-244∆,K417N,E484K,N501Y,A701V",B.1.351 :-18F-244del-246I (variation),7,63,0,1,2,3
"L18F,D80A,D215G,K417N,E484K,N501Y,A701V",B.1.351 :-242del-243del-244del-246I (variation),48,0,0,3,14,17
"L18F,D80A,D215G,242-244∆,K417N,E484K,N501Y,A701V",B.1.351 :-246I (variation),48,24,4,3,19,26
"K417N,E484K,N501Y",B.1.351 RBD,220,66,28,12,84,124
"S13I,W152C,L452R",B.1.427/9,55,139,9,3,27,39
"L5F,T95I,D253G,E484K,A701V",B.1.526,25,20,6,0,1,7
"L5F,T95I,D253G,S477N,A701V",B.1.526 :-484K+477N (variation),6,10,3,0,0,3
"L5F,T95I,D253G,S477N,Q957R",B.1.526 v.2,19,10,0,0,1,1
"T95I,G142D,E154K,L452R,E484Q,P681R,Q1071H",B.1.617,0,28,0,0,0,0
"N501Y,Q677H",COH.20G/677H,10,5,2,0,0,2
"69-70∆,D796H",Kemp21-d101,3,0,0,3,6,9
"69-70∆,Y453F,I692V,S1147L,M1229I",Mink Cluster 5,18,0,2,0,0,2
"L18F,T20N,P26S,D138Y,R190S,K417T,E484K,N501Y,H655Y,T1027I,V1176F",P.1,150,215,28,5,22,55
"K417T,E484K,N501Y",P.1 (variation),0,0,1,0,0,1
"K417T,E484K",P.1 (variation),0,0,1,0,0,1
"E484K,V1176F",P.2,17,71,0,0,0,0
"Y248ins,E484K",PT188_EM,15,0,0,0,4,4
