Variant name,Nickname,CP,VP,mAbs phase3,mAbs structure,other mAbs,all mAbs
"E324G,S325D",,0,0,0,1,7,8
"N439K,F1121L",,0,0,0,2,0,2
"G261D,A475V",,0,0,0,2,0,2
"F490L,Q779H",,0,0,0,2,0,2
"G261D,Y453F",,0,0,1,0,0,1
"T95I,N354K",,0,0,1,0,0,1
"K417T,E484K,N501Y",,0,0,1,0,0,1
"K417T,E484K",,0,0,1,0,0,1
"N354D,D364Y",,0,0,1,0,0,1
"Y453F,Q498H",,0,0,1,0,0,1
"69-70∆,Y453F,F486L,N501T,M1229I",,0,0,1,0,0,1
"141-145∆,R408I",,0,0,1,4,8,13
"D80A,D215G,E484K,N501Y,A701V",,0,0,2,0,0,2
"69-70∆,N439K",,0,0,3,0,0,3
"G446P,F456V,E484P",,1,1,0,0,0,0
SARS-CoV Spike,,1,1,0,0,0,0
"S477N,S514F",,2,2,0,0,10,10
"T345A,L517R",,2,2,0,0,10,10
"69-70∆,N501Y,A570D",,10,10,0,0,0,0
"69-70∆,Y453F",,15,15,4,4,5,13
"69-70∆,N501Y",,15,15,15,5,24,44
"69-70∆,N501Y,P681H",,18,18,2,0,0,2
"E484K,N501Y",,19,19,5,1,10,16
"K444T,V445S,G446T",,36,36,0,1,7,8
"L455Y,F456L",,36,36,0,1,7,8
"T470N,E471V,I472P",,36,36,0,1,7,8
"69-70∆,N501Y,A570D,P681H,T716I,S982A,D1118H",B.1.1.7,475,475,67,32,116,215
"69-70∆,E484K,N501Y,A570D,P681H,T716I,S982A,D1118H",B.1.1.7 +484K(Variation),20,20,0,0,0,0
"69-70∆,N501Y,A570D,P681H",B.1.1.7 S1,0,0,1,0,0,1
"L18F,D80A,D215G,242-244∆,R246I,K417N,E484K,N501Y,A701V",B.1.351,423,423,61,20,48,129
"D80A,D215G,K417N,E484K,N501Y,A701V",B.1.351 :-18F-242del-243del-244del-246I(Variation),6,6,0,1,2,3
"D80A,D215G,242-244∆,K417N,E484K,N501Y,A701V",B.1.351 :-18F-244del-246I(Variation),7,7,0,1,2,3
"L18F,D80A,D215G,242-244∆,K417N,E484K,N501Y,A701V",B.1.351 :-246I(Variation),0,0,4,0,5,9
"K417N,E484K,N501Y",B.1.351 RBD,169,169,26,9,71,106
"S13I,W152C,L452R",B.1.427,46,46,9,3,25,37
"L5F,T95I,D253G,E484K,A701V",B.1.526,0,0,3,0,0,3
"N501Y,Q677H",COH.20G/677H,10,10,2,0,0,2
"69-70∆,D796H",Kemp21-d101,3,3,0,3,6,9
"69-70∆,Y453F,I692V,S1147L,M1229I",Mink Cluster 5,18,18,2,0,0,2
"L18F,T20N,P26S,D138Y,R190S,K417T,E484K,N501Y,H655Y,T1027I,V1176F",P.1,106,106,25,5,14,44
"E484K,V1176F",P.2,5,5,0,0,0,0
"Y248ins,E484K",PT188_EM,15,15,0,0,4,4
