Variant name,Nickname,CP,VP,mAbs phase3,mAbs structure,other mAbs,all mAbs
"E324G,S325D",,0,0,0,1,8,9
"N439K,F1121L",,0,0,0,2,2,4
"G261D,A475V",,0,0,0,2,2,4
"F490L,Q779H",,0,0,0,2,2,4
"G261D,Y453F",,0,0,1,0,1,2
"T95I,N354K",,0,0,1,0,1,2
"N354D,D364Y",,0,0,1,0,1,2
"Y453F,Q498H",,0,0,1,0,1,2
"69-70∆,Y453F,F486L,N501T,M1229I",,0,0,1,0,1,2
"K417T,E484K,N501Y",,0,0,1,0,2,3
"K417T,E484K",,0,0,1,0,2,3
"141-145∆,R408I",,0,0,1,4,13,18
"D80A,D215G,E484K,N501Y,A701V",,0,0,2,0,2,4
"69-70∆,N439K",,0,0,3,0,3,6
"K417N,N501Y",,0,10,0,0,0,0
"K417N,E484K",,0,10,0,0,0,0
WIV1 Spike,,0,24,0,0,0,0
"G446P,F456V,E484P",,1,0,0,0,0,0
SARS-CoV Spike,,1,63,0,0,0,0
"S477N,S514F",,2,0,0,0,10,10
"T345A,L517R",,2,0,0,0,10,10
"69-70∆,N501Y,A570D",,10,15,0,0,0,0
"69-70∆,Y453F",,15,11,4,4,13,21
"69-70∆,N501Y",,15,31,15,6,47,68
"69-70∆,N501Y,P681H",,18,13,2,0,2,4
"E484K,N501Y",,19,54,5,2,18,25
"K444T,V445S,G446T",,36,0,0,1,8,9
"L455Y,F456L",,36,0,0,1,8,9
"T470N,E471V,I472P",,36,0,0,1,8,9
"Y453F,I692V,M1229I",B.1.1.298,0,26,0,0,0,0
"A27S,P681H",B.1.1.50 +681H(Variation),0,18,0,0,0,0
"69-70∆,N501Y,A570D,P681H,T716I,S982A,D1118H",B.1.1.7,475,611,67,33,228,328
"69-70∆,E484K,N501Y,A570D,P681H,T716I,S982A,D1118H",B.1.1.7 +484K(Variation),20,58,0,0,0,0
"69-70∆,N501Y,A570D,P681H",B.1.1.7 S1,0,0,1,0,1,2
"L18F,D80A,D215G,242-244∆,R246I,K417N,E484K,N501Y,A701V",B.1.351,423,418,61,21,142,224
"D80A,242-244∆,R246I,K417N,E484K,N501Y,A701V",B.1.351 :-18F-215G(Variation),0,23,0,0,0,0
"D80A,D215G,K417N,E484K,N501Y,A701V",B.1.351 :-18F-242del-243del-244del-246I(Variation),6,39,0,1,3,4
"D80A,D215G,242-244∆,K417N,E484K,N501Y,A701V",B.1.351 :-18F-244del-246I(Variation),7,63,0,1,3,4
"L18F,D80A,D215G,242-244∆,K417N,E484K,N501Y,A701V",B.1.351 :-246I(Variation),0,24,4,0,9,13
"K417N,E484K,N501Y",B.1.351 RBD,169,66,26,10,113,149
"S13I,W152C,L452R",B.1.427,46,115,9,3,39,51
"L5F,T95I,D253G,E484K,A701V",B.1.526,0,0,3,0,5,8
"N501Y,Q677H",COH.20G/677H,10,5,2,0,2,4
"69-70∆,D796H",Kemp21-d101,3,0,0,3,9,12
"69-70∆,Y453F,I692V,S1147L,M1229I",Mink Cluster 5,18,0,2,0,2,4
"L18F,T20N,P26S,D138Y,R190S,K417T,E484K,N501Y,H655Y,T1027I,V1176F",P.1,106,144,25,5,47,77
"E484K,V1176F",P.2,5,29,0,0,0,0
"Y248ins,E484K",PT188_EM,15,0,0,0,4,4
